7888888888888889
4              6
4              6
4          88883
4              6
4              6
4              6
4       c      6
4              6
4              6
4              6
4              6
4          88883
4              6
4              6
8888888888888888