7888888888888889
4          e   6
4              6
4       78888883
4       4   e  6
4       4      6
4       4      6
4       4      6
4              6
4              6
4              6
4              6
4              6
4              6
4              6
8888888888888888
7888888888888889
4          e   6
4              6
4       78888883
4       4      6
4       4      6
4              6
4              6
4              6
4              6
4    6         6
4    6         6
188888         6
4              6
4  e           6
8888888888888888
7888888888888889
4              6
4              6
4              3
4       4   e  6
4       4      6
4       4   e  6
4       4      6
4              6
4              6
4              6
4              6
4       4      6
4       4      6
4          e   6
8888888888888888
7888888888888889
4              6
4      e       6
4              6
4              6
4              6
4              6
4              6
4              6
4              6
4              6
4   4  e   6   6
4   4      6   6
4   88888888   6
4              6
8888888888888888

